*##########
*#****#***#
*#****#*B*#
*#*#**#*#P#
*#*#*##**##
##*#******#
#**#*####*#
#*********#
#########*#
********#W#
********###